
NO ./Squirtle.png
C 135,206,250
SO ./Eevee.png

EA ./pikachu.png

F 139,119,84
WE ./Bulbasaur.png

1111111111111111111111111
10000000000000001010100001
1001000000000000111000011
100100000010000011000001
10010000000000001000001
11111111101111111111111111111
        101
        101
111 1111101
11111111101111111111111111
100000000W11000001110111111111111
111101111111110111000000100011111111111111111111
1111111111111011101010010001000000010000000000001
1100000011010101110000001000111100000000000001111111111111111111111111111
10000000000000001100000101111111111011111111111111111111111111111
10000000000000000100000000010000000010100000000000110101001001
1111011111111101110000001100111111111011111111111111111111111111111111111
11111111111110111010100100010000000000000000001
1100000011010101110000001100111111110001111111111111111111111111111
100000000000000011000001000111111111010000001111111111111
1111111111111111 11111111111111111111111111111111111111

